ꯑꯈꯠꯄꯤ	akhatpi		
ꯑꯈꯠꯄꯤ ꯅꯨꯄꯤ	akhatpi nupi		
ꯑꯃꯨꯀꯥꯇ꯭ꯔꯣꯡ	amukatrong/amukaatrong		
ꯑꯉꯥꯎꯕꯥ	angaoba/angaobaa		This can also be used in a simple way having no negative meanings. 
ꯑꯉꯥꯎꯕꯤ	angaobi		This can also be used in a simple way having no negative meanings. 
ꯑꯄꯪ	apang		
ꯑꯄꯪ ꯂꯥꯕ	apang laba/ apang laaba		
ꯑꯄꯪ ꯂꯥꯕꯥ	apang laba/ apang laabaa		
ꯑꯄꯪꯖꯥꯎ	apangjao		
ꯕꯦꯁꯥ	besa/besaa		
ꯕꯤꯍꯥꯔꯤ	bihari		This can also be used in a simple way having no negative meanings. 
ꯕꯨꯙꯨ	budhu		
ꯕꯨꯙꯨ ꯂꯥꯕ	budhu laba/budhu laaba		
ꯕꯨꯙꯨ ꯂꯥꯕꯥ	budhu laba/budhu laabaa		
ꯕꯨꯙꯨꯖꯥꯎ	budhujao		
ꯕꯨꯗꯨ	budu		
ꯕꯨꯗꯨ ꯂꯥꯕ	Budu laba/budu laaba		
ꯕꯨꯗꯨ ꯂꯥꯕꯥ	Budu laba/budu laabaa		
ꯕꯨꯗꯨꯖꯥꯎ	budujao		
ꯆꯥꯛꯊꯨ	chaakthu		
ꯆꯛꯊꯨ	chakthu		
ꯆꯥꯎꯈꯠꯇꯕꯥ	chaokhattaba/chaokhattabaa		
ꯒꯗꯥ ꯂꯥꯕ	gada laba/ gadaa laaba		
ꯒꯗꯥ ꯂꯥꯕꯥ	gada laba/ gadaa laabaa		
ꯒꯗꯥ	gada/ gadaa		
ꯒꯗꯥꯖꯥꯎ	gadajao/gadaajao		
ꯒꯙꯥ ꯂꯥꯕ	gadha laba/ gadhaa laaba		
ꯒꯙꯥ ꯂꯥꯕꯥ	gadha laba/ gadhaa laabaa		
ꯒꯙꯥ	gadha/gadhaa		
ꯒꯙꯥꯖꯥꯎ	gadhajao/gadhaajao		
ꯒ꯭ꯌꯥꯟꯊꯨ	gyanthu		
ꯍꯥꯎꯅꯥꯎ	haonao		
ꯍꯥꯎꯊꯤ	haothi		
ꯍꯥꯎꯊꯨ	haothu		
ꯍꯩꯊꯨ	heithu		
ꯍꯩꯊꯨꯖꯥꯎ	heithujao		
ꯍꯩꯊꯨꯖꯦꯟ	heithujen		
ꯍꯩꯊꯨꯔꯩ	heithurei		
ꯍꯩꯊꯨꯔꯤ	heithuri		
ꯍꯤꯡꯆꯥꯕꯥ	hingchaba/hingchaabaa		
ꯍꯤꯡꯆꯥꯕꯤ	hingchabi/hingchaabi		
ꯍꯣꯢꯔꯣꯡ	hoirong		
ꯍꯣꯢꯔꯣꯡ ꯂꯥꯕ	hoirong laba/hoirong laaba		
ꯍꯣꯢꯔꯣꯡ ꯂꯥꯕꯥ	hoirong laba/hoirong laabaa		
ꯍꯣꯢꯔꯣꯡ ꯃꯆꯥ	hoirong macha/hoirong machaa		
ꯍꯣꯢꯔꯣꯡꯖꯥꯎ	hoirongjao		
ꯍꯣꯃꯣ	homo		
ꯍꯨꯢ	hui		This can also be used in a simple way having no negative meanings. 
ꯍꯨꯢꯊꯨ	huithu		
ꯍꯨꯢꯊꯨ ꯂꯥꯕ	huithu laba/ huithu laaba		
ꯍꯨꯢꯊꯨ ꯂꯥꯕꯥ	huithu laba/ huithu laabaa		
ꯍꯨꯢꯊꯨꯖꯥꯎ	huithujao		
ꯍꯨꯔꯥꯟꯕꯥ	huranba/huraanbaa		
ꯍꯨꯔꯥꯟꯕꯤ	huranbi/huraanbi		
ꯏꯔꯣꯢ ꯂꯥꯕ	iroi laba/eroi laba/iroi laaba/eroi laaba		
ꯏꯔꯣꯢ ꯂꯥꯕꯥ	iroi laba/eroi laba/iroi laabaa/eroi laabaa		
ꯏꯔꯣꯢ ꯃꯥꯟꯕꯥ	iroi manba/ eroi manba		
ꯏꯔꯣꯢ	iroi/eroi		
ꯀꯥꯂꯤꯃꯨꯊꯤ	kalimuthi/kaalimuthi		
ꯀꯥꯁꯨ ꯅꯠꯇꯦ	kasu natte/ Kaasu natte		
ꯀꯁꯨꯕꯥ	kasuba/kasubaa		
ꯀꯁꯨꯕꯤ	kasubi		
ꯀꯁꯨꯕꯤ ꯃꯆꯥ	kasubi macha/kasubi machaa		
ꯈꯣꯝꯖꯥꯎꯕꯤ	khomjaobi		
ꯀꯣꯛꯆꯥꯛ	kokchak/kokchaak		
ꯀꯣꯛꯇꯥꯡ	koktang		
ꯂꯝꯆꯠ ꯅꯥꯢꯗꯕꯤ	lamchat naidabi		
ꯂꯝꯖꯥ ꯁꯔꯥ	lamja sara/lamjaa saraa		
ꯂꯝꯁꯥ	lamsa/lamsaa		
ꯂꯋꯥꯏ ꯀꯣꯛ	lawai kok		
ꯂꯋꯥꯢ ꯃꯆꯥ	lawai macha/lawai machaa		
ꯂꯧꯔꯥ	loura/louraa		
ꯂꯨꯈꯥꯛ	lukhaak		
ꯃꯥꯢꯕꯪ	maibang		
ꯃꯥꯢꯕꯪꯖꯥꯎ	maibangjao		
ꯃꯥꯢꯄꯪ	maipang		
ꯃꯔꯥꯢ	marai		
ꯃꯌꯥ ꯀꯥꯛꯄꯤ	mayaa kaakpi		
ꯃꯌꯥꯡ ꯀꯋꯥꯛ	mayang kwak		
ꯃꯌꯥꯡ ꯂꯨꯈꯥꯛ	mayang lukhak		
ꯃꯌꯥꯡ ꯃꯊꯤ	mayang mathi		
ꯃꯌꯥꯡ ꯊꯨꯌꯥꯡ	mayang thuyang		
ꯃꯌꯥꯡꯇꯩ	mayangtei		
ꯃꯦꯈꯔꯥ	mekhara		
ꯃꯤꯅꯥꯢ	minai		
ꯃꯤꯅꯥꯢ ꯂꯥꯕ	minai laba/ minai laaba		
ꯃꯤꯅꯥꯢ ꯂꯥꯕꯥ	minai laba/ minai laabaa		
ꯃꯤꯅꯥꯢ ꯃꯆꯥ	minai macha/minai machaa		
ꯃꯤꯅꯥꯢꯏꯄꯨꯔ	minaipur		
ꯃꯤꯊꯤꯕꯣꯅꯒ ꯃꯤꯇꯝꯕꯥꯜ	mithibong mitambal		
ꯃꯤꯊꯨ	mithu		
ꯃꯨꯊꯤ	muthi		
ꯅꯃꯥꯢꯃꯀꯣꯛ	namaimakok		
ꯅꯃꯥꯢꯃꯠ	Namaimat		
ꯅꯃꯥꯢꯃꯊꯨ	namaimathu		
ꯅꯥꯃꯥꯃꯠ	namamat/naamaamat		
ꯅꯃꯥꯃꯠ	namamat/namaamat		
ꯅꯅꯨꯗꯣ	nanudo		
ꯅꯄꯥ ꯊꯣꯔꯥꯢꯃꯆꯥ	napa thoraimacha/napaa thoraimachaa		
ꯅꯄꯥ ꯌꯥꯅꯤ ꯃꯆꯥ	napa yani macha/ napaa yaani machaa		
ꯅꯊꯤꯕꯣꯡ	nathibong		
ꯅꯣꯢ ꯅꯥꯄꯥ	noi napa/noi naapaa		This can also be used in a simple way having no negative meanings.
ꯑꯣꯛꯇꯕꯤ	oktabi		
ꯑꯣꯛꯊꯨ	okthu		
ꯑꯣꯂꯛꯈꯤ	ollakhi		
ꯔꯧ	rou		
ꯔꯧ ꯅꯨꯄꯤ	rou nupi		
ꯁꯛꯊꯤꯕꯤ	sakthibi		
ꯁꯛꯊꯨ	sakthu		
ꯁꯛꯊꯨ ꯂꯥꯕ	sakthu laba/ sakthu laaba		
ꯁꯛꯊꯨ ꯂꯥꯕꯥ	sakthu laba/ sakthu laabaa		
ꯁꯛꯊꯨ ꯅꯨꯄꯤ	sakthu nupi		
ꯁꯟ ꯃꯥꯟꯕꯥ	san manba		
ꯁꯦꯡꯕꯤ	sengbi		There is another word having the same spelling i.e. ꯁꯦꯡꯕꯤ 'sengbi' as in ‘Thamoi sengbi nupi’ meaning ‘sincere lady’ or ‘a girl with a pure heart’  but the tone is different. 
ꯁꯣꯅꯣ	sono		
ꯊꯤꯕꯥꯏꯀꯣꯟ	thibaikon		
ꯊꯤꯕꯥꯛ  ꯃꯥꯟꯕ	thibak manba		
ꯊꯤꯕꯣꯡꯂꯥꯎ	thibonglao		
ꯊꯤꯕꯨꯛꯀꯪ	thibukkang		
ꯊꯤꯕꯨꯝꯐꯥꯏ	thibumfai		
ꯊꯤꯕꯨꯠ	thibut/thiboot		
ꯊꯤꯆꯥꯕ	thichaba/thichaaba		
ꯊꯤꯆꯥꯕꯥ	thichaba/thichaabaa		
ꯊꯤꯆꯥꯕꯤ	thichabi/thichaabi		
ꯊꯤꯒꯦꯠꯆꯩ	thigetchei		
ꯊꯤꯒꯨꯟ	thigun		This can also be used in a simple way having no negative meanings (as it is a part of the body). 
ꯊꯤꯒꯨꯟꯂꯥꯎ	thigunlao		
ꯊꯤꯖꯥꯕꯥ	thijaba/thijaabaa		
ꯊꯤꯖꯥꯕꯤ	thijabi/thijaabi		
ꯊꯤꯅꯣꯢ	thinoi		
ꯊꯤꯇꯩꯕꯥ	thiteiba		
ꯊꯤꯌꯥꯡꯒꯪ	thiyanggang/thiyaanggang		
ꯊꯤꯌꯥꯡꯀꯪ	thiyangkang/thiyaangkang		
ꯊꯣꯔꯥꯢ ꯃꯆꯥ	thorai macha/thorai machaa		
ꯊꯨꯕꯪ	thubang		
ꯊꯨꯕꯪꯖꯥꯎ	thubangjao		
ꯊꯨꯕꯨꯛꯀꯪ	thubukkang		
ꯊꯨꯒꯥꯛꯄꯤ ꯃꯆꯥ	thugakpi macha/thugaakpi machaa		
ꯊꯨꯒꯥꯛꯄꯤ	thugakpi/thugaakpi		
ꯊꯨꯢ	thui		
ꯊꯨꯖꯛ	thujak		
ꯊꯨꯖꯤꯟꯖꯥꯎ	thujinjao		
ꯊꯨꯖꯤꯟꯊꯤ	thujinthi		
ꯊꯨꯖꯤꯟꯇꯨꯝ	thujintum		
ꯊꯨꯖꯣꯞꯄ	thujoppa		
ꯊꯨꯖꯣꯞꯄꯥ	thujoppa/thujoppaa		
ꯊꯨꯂꯥꯎꯕꯤ	thulaobi		
ꯊꯨꯃꯥꯢꯕꯪ	thumaibang		
ꯊꯨꯃꯥꯢꯒꯟ	thumaigan		
ꯊꯨꯃꯥꯢꯀꯟ	thumaikan		
ꯊꯨꯃꯥꯢꯄꯥꯛ	thumaipak/thumaipaak		
ꯊꯨꯃꯤꯠꯆꯣꯠ	thumitchot		
ꯊꯨꯃꯤꯠꯀꯥꯛ	thumitkak/thumitkaak		
ꯊꯨꯃꯤꯠꯂꯪ	thumitlang		
ꯊꯨꯃꯤꯠꯂꯥꯎ	thumitlao		
ꯊꯨꯃꯤꯠꯇꯥꯡ	thumittang/thumittaang		
ꯊꯨꯃꯤꯠꯇꯣꯡ	thumittong		
ꯊꯨꯃꯤꯠꯌꯨꯡ	thumityung		
ꯊꯨꯃꯣꯠꯆꯩ	thumotchei		
ꯊꯨꯃꯨꯕꯤ	thumubi		
ꯊꯨꯃꯨꯔꯩ	thumurei		
ꯊꯨꯅꯥꯆꯣꯛ	thunachok/thunaachok		
ꯊꯨꯅꯥꯄꯪ	thunapang		
ꯊꯨꯅꯥꯐꯟ	thunaphan		
ꯊꯨꯅꯞꯇꯩ	thunaptei		
ꯊꯨꯉꯥꯎ	thungao		
ꯊꯨꯉꯥꯎꯕꯥ	thungaoba 		
ꯊꯉꯥꯎꯕꯤ	thungaobi		
ꯊꯨꯉꯥꯎꯔꯤ	thungaori		
ꯊꯨꯟꯖꯥꯎꯕꯤ	thunjaobi		
ꯊꯨꯅꯨꯕ	thunuba		
ꯊꯨꯅꯨꯕꯤ	thunubi		
ꯊꯨꯔꯥꯎꯕꯤ	thuraobi		
ꯊꯨꯔꯦꯡꯕꯤ	thurengbi		
ꯊꯨꯔꯤꯕꯤ	thuribi		
ꯊꯨꯁꯃꯦꯟ	thusman/thusssman		
ꯊꯨꯌꯥꯀꯥ	thuya ka		
ꯊꯨꯌꯥꯆꯧ	thuyachou		
ꯊꯨꯌꯥꯡꯒꯪ	thuyanggang/thuyaanggang		
ꯊꯨꯌꯥꯡꯀꯪ	thuyangkang/thuyaangkang		
ꯌꯥꯔꯤ  ꯏꯀꯥꯛ  ꯀꯥꯛꯄꯤ	yaari ikaak kaakpi		
ꯌꯣꯡ ꯃꯊꯨꯟ ꯃꯥꯟꯕ	yong mathun maanba		
